1111111111111111111111111111111111111
10100010100H0000000C00000110000C100E1
10CC00001000000100011000010000010H1C1
10C0000C0010C000C00000010000C00010C01
111100000000000C0000000000000000H00C1
1000100000001000000001100010000H10001
100000C0000H00CC0000000C0000000000001
100100110000000000100100100C011000001
1000001100000100000001000H00001000001
100100C0000000C01100H00C0000H000H1001
100100010000001101100001000C000000001
100010000010000H000000000000C00000001
100000C010000111001110111C00011000001
10000000100001C0H010H001C000001111001
101000001000011000110H010000C00000001
100000101C0001C0001000010000000000001
11000H1011100111001110010000C01010101
1100C01000000000000000010000000000001
11P1010000100C00H00000C00100C00000001
1111111111111111111111111111111111111